wwwwwwwwwwwwwwwwwwwwwwwwww
wx---------cA---x--------w
w---------------------x--w
wwwwww-------------------w
w-x--w----------x--------w
w---------------------c-xw
w----w------------wwww-www
w----w-------x--------x--w
w--x---------------------w
w----wwwww---------------w
w----cw-------------x----w
w---x-w----e-------------w
wwwwwwwwwwwwwwwwwwwwwwwwww